%%%%%%%%%%%%%%%%%%%%%%%%%%%%%%%
%............%%%%%............%
%%%.%...%%%.........%.%...%.%%%
%.  %%% %.%%%% % %%%%%% %%%   %
% % .   %  .   %  .   %  .  % %
% %%% %%%%% %%%%%%% %%% % %%%%%
%.....%........P....%...%.....%
%%%%%%%%%%%%%%%%%%%%%%%%%%%%%%%
