%%%%%%%%%%%%%%%%%%%%%%%%%%%%%%%
%. . .   .  .%%%%%.  .  .    .%
%%% %   %%%    .    % % . % %%%
%.  %%% %.%%%% % %%%%%% %%%   %
% % .   %  .   %  .   %  .  % %
% %%% %%%%% %%%%%%% %%% % %%%%%
%.   .%  .  .  P .  %.  % .  .%
%%%%%%%%%%%%%%%%%%%%%%%%%%%%%%%
